AL=Albania
DZ=Algeria
AO=Angola
AR=Argentina
AM=Armenia
AU=Australia
AT=Austria
AZ=Azerbaijan
BH=Bahrain
BD=Bangladesh
BY=Belarus
BE=Belgium
BJ=Benin
BO=Bolivia
BA=Bosnia & Herzegovina
BR=Brazil
BG=Bulgaria
BF=Burkina Faso
KH=Cambodia
CM=Cameroon
CA=Canada
CL=Chile
CO=Colombia
CD=Congo - Kinshasa
CR=Costa Rica
CI=Côte d'Ivoire
HR=Croatia
CU=Cuba
CY=Cyprus
CZ=Czechia
DK=Denmark
DO=Dominican Republic
EC=Ecuador
EG=Egypt
SV=El Salvador
EE=Estonia
ET=Ethiopia
FI=Finland
FR=France
GE=Georgia
DE=Germany
GH=Ghana
GR=Greece
GT=Guatemala
HT=Haiti
HN=Honduras
HK=Hong Kong
HU=Hungary
IN=India
ID=Indonesia
IR=Iran
IQ=Iraq
IE=Ireland
IL=Israel
IT=Italy
JM=Jamaica
JP=Japan
JO=Jordan
KZ=Kazakhstan
KE=Kenya
KW=Kuwait
KG=Kyrgyzstan
LV=Latvia
LB=Lebanon
LY=Libya
LT=Lithuania
MY=Malaysia
ML=Mali
MX=Mexico
MD=Moldova
MA=Morocco
MZ=Mozambique
MM=Myanmar (Burma)
NP=Nepal
NL=Netherlands
NZ=New Zealand
NI=Nicaragua
NG=Nigeria
MK=North Macedonia
NO=Norway
OM=Oman
PK=Pakistan
PS=Palestine
PA=Panama
PY=Paraguay
PE=Peru
PH=Philippines
PL=Poland
PT=Portugal
PR=Puerto Rico
QA=Qatar
RO=Romania
RU=Russia
SA=Saudi Arabia
SN=Senegal
RS=Serbia
SG=Singapore
SK=Slovakia
SI=Slovenia
ZA=South Africa
KR=South Korea
ES=Spain
LK=Sri Lanka
SE=Sweden
CH=Switzerland
SY=Syria
TW=Taiwan
TZ=Tanzania
TH=Thailand
TT=Trinidad & Tobago
TN=Tunisia
TR=Türkiye
TM=Turkmenistan
UG=Uganda
UA=Ukraine
AE=United Arab Emirates
GB=United Kingdom
US=United States
UY=Uruguay
UZ=Uzbekistan
VE=Venezuela
VN=Vietnam
YE=Yemen
ZM=Zambia
ZW=Zimbabwe